1 1 1 1 1 1 1 1 1 1 1 3 6 3 5 3 7 7 7 7 
1 1 1 1 1 1 1 1 1 1 1 3 0 0 0 4 7 7 7 7
1 1 1 1 1 1 1 1 1 1 1 3 0 0 0 3 7 7 7 7
1 1 1 1 1 1 1 1 1 1 1 3 0 0 0 4 7 7 7 7
1 1 1 1 1 1 1 1 1 1 1 0 0 0 0 3 7 7 7 7
1 1 1 1 1 1 1 1 1 1 1 0 0 0 0 4 7 7 7 7
1 1 1 1 1 1 1 1 1 1 1 0 0 3 3 3 7 7 7 7
1 1 1 1 1 1 1 1 1 1 1 2 2 2 2 2 7 7 7 7
1 1 1 1 1 1 1 1 1 1 1 2 2 2 2 2 7 7 7 7
1 1 1 1 1 1 1 1 1 1 1 2 2 2 2 2 7 7 7 7
1 1 1 1 1 1 1 1 1 1 1 2 2 2 2 2 7 7 7 7
1 1 1 1 1 1 1 1 1 1 1 2 2 2 2 2 7 7 7 7
7 7 7 7 7 7 7 7 7 7 7 7 7 7 7 7 7 7 7 7
